*************************************************
*                                               *
*                                               *
*                                               *
*                                               *
*                                               *
*                                               *
*                                               *
*                                               *
*                                               *
*                                               *
*                                               *
*                                               *
*                                               *
*                                               *
*                                               *
*                                               *
*                                               *
*           E       E                           *
*                                               *
*                                               *
*                                               *
*                                               *
*                                               *
*                                               *
*           E       E                           *
*                                               *
*                                               *
*                                               *
*                                               *
*                                               *
*                                               *
*                                               *
*                                               *
*                                               *
*                                               *
*                                               *
*                                               *
*                                               *
*                                               *
*                                               *
*                                               *
*                                               *
*                                               *
*                                               *
*                                               *
*                                               *
*                                               *
*                                               *
*************************************************
