*********************************
*                               *
*                               *
*  ***************************  *
*  *                         *  *
*  *                         *  *
*  *                         *  *
*  *                         *  *
*  *                         *  *
*  *                         *  *
*  *                         *  *
*  ***************************  *
*  X                            *
*                               *
*********************************

