***********************************
*                                 *
*                                 *
*                                 *
*   ***************************   *
*   *                         *   *
*   *                         *   *
*   *                         *   *
*   *                         *   *
*   *                         *   *
*   *                         *   *
*   *                         *   *
*   *                         *   *
*   *                         *   *
*   ***************************   *
*                                 *
*  X                              *
*                                 *
***********************************

