***********   **************************************
*         *  *                                     *                          
*         ***                                      *                           
*         *                                        *                           
*         *                                        *                           
*         *          *           *********         *                           
*                    *           *       *         *                          
*                    *           *       *         *                           
 *                  **           *       *         *                           
  **             *** *           *       *         *                           
    **************   *           *       *         *************************** 
  **              ** *           *********                                    *
 *                  **           *                                            *
*                    *           *                                           *
*                    *           *                                          *  
*         *          *           *              *                          *  
*         *          *                          *                         *   
*         *          *                          *                        *    
*         *          *                         ***                      *     
*         *          *                      ***  ****                  *      
*         *          *               ********        *********        *       
*         *          *                      ***   ***                *        
*         *          *                         ***                  *         
*                    *                          *                  *          
*                    *                          *                 *
*                    *                          *                *            
*                                               *               *             
 *                                              *              *
  *                             *                             *
   ********                    * *                           *
           *                  *   *                  X      *
            *                *     *                       *
             ****           *       *                     *
                 ***********         *********************
