************************          *********************
*                       *       **                    *
*  X                     *     *                      * 
*                         *   *                       *
*****************          *  *         ***************
                 *          * *        *
                  *          **       *
                   *          *      *
                    *                *
                     *               *
                      *             *
                       **         **
                         ***   ***
                           *****
