**************************
*  	                    *
*                      *
*                     *
*                    *
*                   *
*                  *
*  X              *
*                *
*               *
*              *
*             *
*            *
*           *
*          *
*         *
*        *
*       *
*      *
*     *
*    *
*   *
*  *
* *
**
