*************************************************
*                                               *
*                                               *
*                                               *
*                                               *
*                                               *
*                                               *
*                                               *
*                                               *
*                                               *
*                                               *
*                                               *
*                                               *
*                                               *
*                                               *
*      E                              E         *
*                                               *
*                                               *
*                                               *
*                                               *
*                                               *
*                                               *
*                                               *
*                                               *
*                                               *
*                                               *
*                                               *
*                  E                            *
*                                               *
*                                               *
*                                               *
*                                               *
*                                               *
*                                               *
*                                               *
*                                               *
*                                               *
*                                               *
*                                               *
*                                               *
*                                               *
*                                               *
*                                               *
*                                               *
*                                               *
*                                               *
*                           E                   *
*                                               *
*                                               *
*************************************************
